11:1111:11111111
                                        
 XXXXXXXXXXXXXXXXXXXXXXXXXXXXXXXXXXXXXX 
 XXXXX................................X 
 XXX..................................X 
 XX...................................X 
 XX.............X.....................X 
 X.............X......................X 
 X............X.......................X 
 X...........X........................X 
XX..........X.........................XX
XS.........X..........................FX
XX........X...........................XX
 X........X...........................X 
 X........X...1.2.3...................X 
 X........X...........................X 
 X........X...........................X 
 X........X...........................X
 X........X...........................X 
 X........X...........................X 
 X........X...........................X 
 XXXXXXXXXXXXXXXXXXXXXXXXXXXXXXXXXXXXXX 
                                        